: Cancel
Archon: Move, Stop, MoveHoldPosition, Attack, MovePatrol, Rally
Armory: TerranVehicleWeaponsLevel1/Armory, Cancel, Halt, TerranVehiclePlatingLevel1/Armory, TerranShipWeaponsLevel1/Armory, TerranShipPlatingLevel1/Armory, SelectBuilder
Assimilator: Cancel
AutoTestAttackTargetAir: Move, Stop, MoveHoldPosition, MovePatrol
AutoTestAttackTargetGround: Move, Stop, MoveHoldPosition, MovePatrol
AutoTestAttacker: Move, Stop, MoveHoldPosition, Attack, MovePatrol
AutoTurret: Stop, Attack
Baneling: Move, Stop, MoveHoldPosition, Attack, MovePatrol, SapStructure/Baneling, Explode/Baneling, BurrowDown
BanelingBurrowed: Attack, BurrowUp, Explode/BanelingBurrowed
BanelingCocoon: Cancel, Rally
BanelingNest: Cancel, EvolveCentrificalHooks/BanelingNest
Banshee: Move, Stop, MoveHoldPosition, Attack, MovePatrol, CloakOnBanshee, CloakOff
Barracks: Marine/Barracks, Marauder/Barracks, Reaper/Barracks, Ghost/Barracks, Rally, Lift, Halt, Reactor/Barracks, TechLabBarracks/Barracks, Cancel, SelectBuilder
BarracksFlying: Land, Reactor/BarracksFlying, TechLabBarracks/BarracksFlying, Stop, Move, MoveHoldPosition, MovePatrol
BarracksTechLab: Cancel, ResearchShieldWall/BarracksTechLab, Stimpack/BarracksTechLab, ResearchPunisherGrenades/BarracksTechLab, ReaperSpeed/BarracksTechLab
Battlecruiser: Move, Stop, MoveHoldPosition, MovePatrol, Attack, YamatoGun
BroodLord: Move, Stop, MoveHoldPosition, Attack, MovePatrol, SwarmSeeds/BroodLord
BroodLordCocoon: Move, Stop, MoveHoldPosition, MovePatrol, Attack, Cancel
Broodling: Move, Stop, MoveHoldPosition, Attack, MovePatrol
Bunker: Attack, Stop, Stim, SetBunkerRallyPoint/Bunker, BunkerLoad, BunkerUnloadAll, Salvage/Bunker, Halt, Cancel, SelectBuilder
Carrier: Move, Stop, MoveHoldPosition, Attack, MovePatrol, Interceptor/Carrier, Cancel, GravitonCatapult/Carrier
Changeling: Move, Stop, MoveHoldPosition, MovePatrol, Attack, Disguise/Changeling
Colossus: Move, Stop, MoveHoldPosition, Attack, MovePatrol, CliffWalk/Colossus
CommandCenter: SCV, OrbitalCommand/CommandCenter, UpgradeToPlanetaryFortress/CommandCenter, Rally, CommandCenterLoad, CommandCenterUnloadAll, Lift, Halt, Cancel, SelectBuilder
CommandCenterFlying: Land, Stop, Move, CommandCenterLoad, CommandCenterUnloadAll, MoveHoldPosition, MovePatrol
Corruptor: Move, Stop, MoveHoldPosition, Attack, MovePatrol, BroodLord/Corruptor, CorruptionAbility/Corruptor, Cancel
CreepTumorBurrowed: Cancel, BuildCreepTumorPropagate/CreepTumorBurrowed
Critter: Move, Stop, MoveHoldPosition, MovePatrol, Attack
CyberneticsCore: ProtossAirWeaponsLevel1/CyberneticsCore, ProtossAirArmorLevel1/CyberneticsCore, Cancel, ResearchWarpGate/CyberneticsCore, ResearchHallucination/CyberneticsCore
DarkShrine: Cancel
DarkTemplar: Move, Stop, MoveHoldPosition, Attack, MovePatrol, Rally, AWrp, PermanentlyCloaked/DarkTemplar
Drone: Move, Stop, MoveHoldPosition, Attack, MovePatrol, ReturnCargo, ZergBuild/Drone, ZergBuildAdvanced/Drone, BurrowDown, GatherProt
Drone - ZBl1: Hatchery/Drone, Extractor/Drone, SpawningPool/Drone, EvolutionChamber/Drone, BanelingNest/Drone, Cancel, RoachWarren/Drone, SpineCrawler/Drone, SporeCrawler/Drone
Drone - ZBl2: Spire/Drone, UltraliskCavern/Drone, Cancel, NydusNetwork/Drone, InfestationPit/Drone, HydraliskDen/Drone
DroneBurrowed: Attack, BurrowUp
Egg: Rally, Cancel, Attack
EngineeringBay: TerranInfantryWeaponsLevel1/EngineeringBay, Cancel, Halt, ResearchNeosteelFrame/EngineeringBay, UpgradeBuildingArmorLevel1/EngineeringBay, ResearchHiSecAutoTracking/EngineeringBay, TerranInfantryArmorLevel1/EngineeringBay, SelectBuilder
EvolutionChamber: Cancel, zerggroundarmor1/EvolutionChamber, zergmeleeweapons1/EvolutionChamber, zergmissileweapons1/EvolutionChamber
Extractor: Cancel
Factory: Hellion/Factory, SiegeTank/Factory, Thor/Factory, Rally, Lift, Halt, Reactor/Factory, TechLabFactory/Factory, Cancel, SelectBuilder
FactoryFlying: Land, Reactor/FactoryFlying, BuildTechLabFactory/FactoryFlying, Stop, Move, MoveHoldPosition, MovePatrol
FactoryTechLab: Cancel, ResearchHighCapacityBarrels/FactoryTechLab, ResearchSiegeTech/FactoryTechLab
FleetBeacon: Cancel, ResearchVoidRaySpeedUpgrade/FleetBeacon, ResearchInterceptorLaunchSpeedUpgrade/FleetBeacon
Forge: Cancel, ProtossGroundWeaponsLevel1/Forge, ProtossGroundArmorLevel1/Forge, ProtossShieldsLevel1/Forge
FusionCore: ResearchBattlecruiserSpecializations/FusionCore, Cancel, Halt, ResearchBattlecruiserEnergyUpgrade/FusionCore, SelectBuilder
Gateway: Cancel, Zealot, Stalker, HighTemplar, DarkTemplar, Rally, UpgradeToWarpGate/Gateway, Sentry
Ghost: Move, Stop, MoveHoldPosition, MovePatrol, GhostHoldFire/Ghost, Cancel, Attack, Snipe/Ghost, NukeCalldown/Ghost, CloakOnBanshee, CloakOff, EMP/Ghost, WeaponsFree/Ghost
GhostAcademy: ResearchPersonalCloaking/GhostAcademy, Cancel, Halt, NukeArm/GhostAcademy, ResearchGhostEnergyUpgrade/GhostAcademy, SelectBuilder
GreaterSpire: Cancel, zergflyerattack1, zergflyerarmor1
Hatchery: Larva, Cancel, Lair/Hatchery, RallyEgg, Queen, Rally, overlordspeed, ResearchBurrow, EvolveVentralSacks
Hellion: Move, Stop, MoveHoldPosition, Attack, MovePatrol
HighTemplar: Move, Stop, MoveHoldPosition, MovePatrol, Attack, Rally, AWrp, PsiStorm/HighTemplar, Feedback/HighTemplar
Hive: Larva, Cancel, RallyEgg, Rally, Queen, overlordspeed, ResearchBurrow, EvolveVentralSacks
Hydralisk: Move, Stop, MoveHoldPosition, Attack, MovePatrol, BurrowDown
HydraliskBurrowed: Attack, BurrowUp
HydraliskDen: Cancel, hydraliskspeed/HydraliskDen
Immortal: Move, Stop, MoveHoldPosition, Attack, MovePatrol, HardenedShield/Immortal
InfestationPit: Cancel, EvolvePeristalsis/InfestationPit, EvolveInfestorEnergyUpgrade/InfestationPit
InfestedTerransEgg: Move, Stop, MoveHoldPosition, MovePatrol, Attack
Infestor: Move, Stop, MoveHoldPosition, MovePatrol, FungalGrowth/Infestor, InfestedTerrans/Infestor, NeuralParasite/Infestor, Attack, BurrowDown, Cancel
InfestorBurrowed: Move, Stop, MoveHoldPosition, MovePatrol, BurrowUp, Attack
InfestorTerran: Move, Stop, MoveHoldPosition, Attack, MovePatrol, BurrowDown
InfestorTerranBurrowed: Attack, BurrowUp
Interceptor: Move, Stop, MoveHoldPosition, Attack, MovePatrol
Lair: Larva, Cancel, Hive/Lair, RallyEgg, Rally, Queen, overlordspeed, ResearchBurrow, EvolveVentralSacks
Larva: Drone/Larva, Zergling/Larva, Overlord/Larva, Roach/Larva, Mutalisk/Larva, Infestor/Larva, Ultralisk/Larva, Corruptor/Larva, Cancel, Hydralisk/Larva
MULE: Move, Stop, MoveHoldPosition, Attack, MovePatrol, GatherProt, Repair, ReturnCargo
Marauder: Move, Stop, MoveHoldPosition, MovePatrol, Attack, ConcussiveGrenade/Marauder, Stim
Marine: Move, Stop, MoveHoldPosition, Attack, MovePatrol, Stim
Medivac: Move, Stop, MoveHoldPosition, MovePatrol, BunkerLoad, Attack, Heal/Medivac, BunkerUnloadAll
MissileTurret: Halt, Cancel, Stop, Attack, Detector/MissileTurret, SelectBuilder
Mothership: Move, Stop, MoveHoldPosition, MovePatrol, Attack, CloakingField/Mothership, MassRecall/Mothership, Vortex/Mothership
Mutalisk: Move, Stop, MoveHoldPosition, Attack, MovePatrol
Nexus: Cancel, Probe/Nexus, Rally, Mothership/Nexus, TimeWarp/Nexus
NydusCanal: Stop, Rally, BunkerLoad, BunkerUnloadAll
NydusNetwork: Cancel, BunkerLoad, BunkerUnloadAll, Rally, SummonNydusWorm/NydusNetwork, Stop
Observer: Move, Stop, MoveHoldPosition, MovePatrol, Attack, PermanentlyCloakedObserver/Observer, Detector/Observer
OrbitalCommand: SCV, Lift, Cancel, Scan/OrbitalCommand, Rally, CalldownMULE/OrbitalCommand, SupplyDrop/OrbitalCommand
OrbitalCommandFlying: Land, Stop, Move, CommandCenterLoad, BunkerUnloadAll, MoveHoldPosition, MovePatrol
Overlord: Move, Stop, MoveHoldPosition, Attack, MovePatrol, MorphToOverseer/Overlord, Cancel, GenerateCreep/Overlord, BunkerLoad, BunkerUnloadAll, StopGenerateCreep
OverlordCocoon: Move, Stop, MoveHoldPosition, Attack, MovePatrol, Cancel
OverlordGenerateCreepKeybind: StopGenerateCreep
Overseer: Move, Stop, MoveHoldPosition, Attack, MovePatrol, SpawnChangeling/Overseer, Detector/Overseer
Phoenix: Move, Stop, MoveHoldPosition, Attack, MovePatrol, Cancel, GravitonBeam/Phoenix
PhotonCannon: Cancel, Stop, Attack, Detector/PhotonCannon
PlanetaryFortress: CommandCenterLoad, CommandCenterUnloadAll, StopPlanetaryFortress/PlanetaryFortress, Attack, Cancel, SCV, Rally
PointDefenseDrone: PointDefense/PointDefenseDrone
Probe: Move, Stop, MoveHoldPosition, Attack, MovePatrol, GatherProt, ReturnCargo, ProtossBuild/Probe, ProtossBuildAdvanced/Probe
Probe - PBl1: Nexus/Probe, Assimilator/Probe, Pylon/Probe, Gateway/Probe, Forge/Probe, CyberneticsCore/Probe, Cancel, PhotonCannon/Probe
Probe - PBl2: Stargate/Probe, TemplarArchive/Probe, RoboticsFacility/Probe, FleetBeacon/Probe, Cancel, DarkShrine/Probe, TwilightCouncil/Probe, RoboticsBay/Probe
Pylon: Cancel
Queen: Move, Stop, MoveHoldPosition, MovePatrol, Attack, MorphMorphalisk/Queen, BuildCreepTumor/Queen, Transfusion/Queen, BurrowDown
QueenBurrowed: Attack, BurrowUp
Raven: Move, Stop, MoveHoldPosition, MovePatrol, AutoTurret/Raven, Attack, Detector/Raven, HunterSeekerMissile/Raven, PointDefenseDrone/Raven
Reactor: Cancel
Reaper: Move, Stop, MoveHoldPosition, Attack, MovePatrol, JetPack/Reaper
RedstoneLavaCritter: Move, Stop, MoveHoldPosition, MovePatrol, BurrowDown
RedstoneLavaCritterBurrowed: Move, Stop, MoveHoldPosition, MovePatrol, BurrowUp
RedstoneLavaCritterInjured: Move, Stop, MoveHoldPosition, MovePatrol, BurrowDown
RedstoneLavaCritterInjuredBurrowed: Move, Stop, MoveHoldPosition, MovePatrol, BurrowUp
Refinery: Halt, Cancel, SelectBuilder
Roach: Move, Stop, MoveHoldPosition, Attack, MovePatrol, RapidRegeneration/Roach, BurrowDown
RoachBurrowed: Attack, BurrowUp, RapidRegeneration/RoachBurrowed, Move, Stop, MoveHoldPosition, MovePatrol
RoachWarren: Cancel, EvolveGlialRegeneration/RoachWarren, EvolveTunnelingClaws/RoachWarren
RoboticsBay: ResearchExtendedThermalLance/RoboticsBay, Cancel, ResearchGraviticBooster/RoboticsBay, ResearchGraviticDrive/RoboticsBay
RoboticsFacility: Cancel, Colossus/RoboticsFacility, Observer/RoboticsFacility, Rally, WarpPrism/RoboticsFacility, Immortal/RoboticsFacility
SCV: Move, Stop, MoveHoldPosition, Attack, MovePatrol, Repair, GatherProt, ReturnCargo, TerranBuild/SCV, TerranBuildAdvanced/SCV, Halt
SCV - TBl1: CommandCenter/SCV, Refinery/SCV, SupplyDepot/SCV, Barracks/SCV, EngineeringBay/SCV, Bunker/SCV, MissileTurret/SCV, SensorTower/SCV, Cancel
SCV - TBl2: GhostAcademy/SCV, Factory/SCV, Armory/SCV, Starport/SCV, FusionCore/SCV, Cancel
ScopeTest: Move, Stop, MoveHoldPosition, Attack, MovePatrol
SensorTower: RadarField/SensorTower, Halt, Cancel, SelectBuilder
Sentry: Move, Stop, MoveHoldPosition, MovePatrol, Attack, Rally, ForceField/Sentry, GuardianShield/Sentry, Hallucination/Sentry
Sentry - HTH1: ProbeHallucination/Sentry, ZealotHallucination/Sentry, StalkerHallucination/Sentry, ImmortalHallucination/Sentry, HighTemplarHallucination/Sentry, ArchonHallucination/Sentry, VoidRayHallucination/Sentry, PhoenixHallucination/Sentry, WarpPrismHallucination/Sentry, ColossusHallucination/Sentry, Cancel
SiegeTank: Move, Stop, MoveHoldPosition, Attack, MovePatrol, SiegeMode, Unsiege
SpawningPool: Cancel, zerglingmovementspeed/SpawningPool, zerglingattackspeed/SpawningPool
SpineCrawler: Cancel, Stop, Attack, SpineCrawlerUproot/SpineCrawler
SpineCrawlerUprooted: Attack, Move, MoveHoldPosition, MovePatrol, Stop, SpineCrawlerRoot/SpineCrawlerUprooted, Cancel
Spire: Cancel, GreaterSpire/Spire, zergflyerattack1, zergflyerarmor1
SporeCrawler: Cancel, Stop, Attack, SporeCrawlerUproot/SporeCrawler, Detector/SporeCrawler
SporeCrawlerUprooted: Attack, Move, MoveHoldPosition, MovePatrol, Stop, SporeCrawlerRoot/SporeCrawlerUprooted, Cancel
Stalker: Move, Stop, MoveHoldPosition, Attack, MovePatrol, Rally, Blink/Stalker
Stargate: Cancel, Phoenix/Stargate, Carrier/Stargate, Rally, VoidRay/Stargate
Starport: VikingFighter/Starport, Medivac/Starport, Raven/Starport, Banshee/Starport, Battlecruiser/Starport, Rally, TechLabStarport/Starport, Reactor/Starport, Lift, Halt, Cancel, SelectBuilder
StarportFlying: Land, Reactor/StarportFlying, BuildTechLabStarport/StarportFlying, Stop, Move, MoveHoldPosition, MovePatrol
StarportTechLab: Cancel, ResearchMedivacEnergyUpgrade/StarportTechLab, ResearchBansheeCloak/StarportTechLab, ResearchRavenEnergyUpgrade/StarportTechLab, ResearchDurableMaterials/StarportTechLab, ResearchSeekerMissile/StarportTechLab
SupplyDepot: Halt, Cancel, Lower/SupplyDepot, SelectBuilder
SupplyDepotLowered: Raise/SupplyDepotLowered
TechLab: Cancel
TemplarArchive: Cancel, ResearchPsiStorm/TemplarArchive, ResearchHighTemplarEnergyUpgrade/TemplarArchive
Thor: Move, Stop, MoveHoldPosition, Attack, MovePatrol, 250mmStrikeCannons/Thor, Cancel
TwilightCouncil: Cancel, ResearchStalkerTeleport/TwilightCouncil, ResearchCharge/TwilightCouncil
Ultralisk: Move, Stop, MoveHoldPosition, Attack, MovePatrol, BurrowDown
UltraliskBurrowed: Attack, BurrowUp
UltraliskCavern: Cancel, EvolveAnabolicSynthesis2/UltraliskCavern, EvolveChitinousPlating/UltraliskCavern
VikingAssault: Move, MovePatrol, MoveHoldPosition, Stop, Attack, FighterMode, AssaultMode
VoidRay: Move, Stop, MoveHoldPosition, Attack, MovePatrol, PrismaticBeam/VoidRay
WarpGate: Zealot, Stalker, HighTemplar, DarkTemplar, Rally, MorphBackToGateway/WarpGate, Sentry
WarpPrism: Move, Stop, MoveHoldPosition, MovePatrol, Attack, BunkerLoad, BunkerUnloadAll, PhasingMode/WarpPrism
WarpPrismPhasing: Move, Stop, MoveHoldPosition, MovePatrol, Attack, BunkerLoad, BunkerUnloadAll, TransportMode/WarpPrism
Zealot: Move, Stop, MoveHoldPosition, Attack, MovePatrol, Rally, Charge/Zealot
Zergling: Move, Stop, MoveHoldPosition, Attack, MovePatrol, Baneling/Zergling, BurrowDown
ZerglingBurrowed: Attack, BurrowUp
